|-----------------------------------------------------------------------------|
|                                                                             |
| |--------------------------|        |-----------------------|               |
| |2...............P...O.....|        |..E....................|               |
| |.E.......G....P...W.......+########+.G.....................|-------|       |
| |..G........\..........H..O|   #    |...............................|--|    |
| |..........................|   #    |O.................................|--| |
| |----------+---------------|   #    |----+----------------|...............| |
|            #                 #############                |...............| |
|            #                 #     |-----+------|         |......W....3...| |
|            #                 #     |P...G.5.....|         |...............| |
|            ###################     |PO.....W....|   ######+...............| |
|            #                 #     |..W.G....W..|   #     |...............| |
|            #                 #     |-----+------|   #     |--------+------| |
|  |---------+-----------|     #           #          #              #        |
|  |....................G|     #           #          #         |----+------| |
|  |.............G.......|     ########################         |L..........| |
|  |.....................|     #           #                    |.....EW....| |
|  |.....P....2E..O......|     #    |------+--------------------|MP.........| |
|  |...@..........G......|     #    |............................G....G.....| |
|  |...................E.+##########+..O.............................D......| |
|  |.....................|          |.......................................| |
|  |---------+-----------|          |---------------------------------------| |
|                                                                             |
|-----------------------------------------------------------------------------|
