"|-----------------------------------------------------------------------------|\
|                                                                             |\
| |--------------------------|        |-----------------------|               |\
| |..........................|        |.......................|               |\
| |..........................+########+.......................|-------|       |\
| |..........................|   #    |...............................|--|    |\
| |..........................|   #    |..................................|--| |\
| |----------+---------------|   #    |----+----------------|...............| |\
|            #                 #############                |...............| |\
|            #                 #     |-----+------|         |...............| |\
|            #                 #     |............|         |...............| |\
|            ###################     |............|   ######+...............| |\
|            #                 #     |............|   #     |...............| |\
|            #                 #     |-----+------|   #     |--------+------| |\
|  |---------+-----------|     #           #          #              #        |\
|  |.....................|     #           #          #         |----+------| |\
|  |.....................|     ########################         |...........| |\
|  |.....................|     #           #                    |...........| |\
|  |.....................|     #    |------+--------------------|...........| |\
|  |.....................|     #    |.......................................| |\
|  |.....................+##########+.......................................| |\
|  |.....................|          |.......................................| |\
|  |---------+-----------|          |---------------------------------------| |\
|                                                                             |\
|-----------------------------------------------------------------------------|";